afr=Afr
amer=Amer
american=American
asian=Asian
white=White
ct=CT
cr=CR
mr=MR
mri=MRI
us=US
pet=PET
gi=GI
nm=NM
xr=XR
pta=PTA
ap=AP
t2=T2
t1=T1
t1w=T1W
tse=TSE
pd=PD
gi=GI
gu=GU
ekg=EKG
ecg=ECG
b12=B12
bx=BX
ucla=UCLA
abo=ABO
rh=Rh
bp=BP
ab=AB
ahg=AHG
afb=AFB
hrct=HRCT
id=ID
ax=AX
fse=FSE
spgr=SPGR
3d=3D
loc=LOC
mip=MIP
cor=COR
mra=MRA
sag=SAG
ob=OB
fi2d=FI2D
pd=PD
pl=PL
zip=ZIP
fs=FS
hrcct=HRCCT
pa=PA
ss=SS
bh=BH
ca=Ca
htn=HTN
ln=LN
ht=HT
cns=CNS
lat=LAT
tiw=TIW
cv=CV
pca=PCa
copd=COPD
hfv=HFV
px=Px
pe=PE
gyn=Gyn
kub=KUB
tra=TRA
pat=PAT
w=W
co=CO
siemens=Siemens
fuji=Fuji
ge=GE
hispeed=HiSpeed
fourier=Fourier
spect=SPECT
fl2d=FL2D
dejarnette=Dejarnette
chs=CHS
ctu=CTU
imageshare=ImageShare
sensation=Sensation
medical=Medical
center=Center
plaza=Plaza
january=January
february=February
march=March
april=April
may=May
june=June
july=July
august=August
september=September
october=October
november=November
december=December
genesis=Genesis
signa=Signa
mr2=MR2
mr1=MR1
se=SE
abd=ABD
trio=Trio
ct4=CT4
flair=FLAIR
fve=FVE
epi=EPI
wb=WB
emotion=Emotion
duo=Duo
atl=ATL
hdi=HDI
mp300=MP300
smr4=SMR4
mp3=MP3
lightspeed=LightSpeed
qx=QX
memp=MEMP
fcmemp=FCMEMP
dwi=DWI
adc=ADC
monica=Monica
santa=Santa
gre=GRE
bl=BL
sfe=SFE
tw=TW
brw=BRW
lu=LU
cc=CC
Mm=MM
ir=IR
lpo=LPO
rpo=RPO
fstir=FSTIR
mlo=MLO
t=T
l=L
c=C
b=B
stx=STX
stir=STIR
pdw=PDW
t2w=T2W
te=TE
mrs=MRS
ws=WS
fr=FR
iac=IAC
aff=AFF
/c/t/l=C/T/L
mp=MP
mpr=MPR
ns=NS
ml=ML
ep2d=EP2D
mp100=MP100
2d=2D
npw=NPW
cta=CTA
